
PS3 Jogos

Assassin's Creed Black Flag = Ação
Bejeweled 2 ou 3 = Combinar 3
Brain Challenge = Pensar
Call of Duty Advanced Warfare = Tiro
Call of Duty Modern Warfare 3 = Tiro
CastleStorm = Defender Castelo
Dead Island = Ação Sobrevivência
Diablo 3 Reaper of the Souls = RPG Ação
Disgaea 3,4 ou D2  = RPG Turno
Dungeon Defenders = Ação Estratégia Defender a base 
Eiyu Senki = RPG Turno Conquista
Everybody Golf = Esportes Golfe
Fairy Fencer = Ação 2D
Far Cry 3 ou 4 = Ação Tiro
Farming Simulator 1 ou 15 = Simulação
Fifa = Esportes Futebol
Gran Turismo 5 ou 6 = Corrida Carro
Grid = Corrida
Hight Stakes Poker = Poquer
Hyperdimension Neptunia ( 1, mk2 e Victory ) = RPG turno
Injustice = Luta
L.A Noire = Investigação
Life Strange = Simulação Vida
Magic Duels, 2012, 2013 ou 2014 = Cartas
Minecraft = Ação Simulação
Monopoly = Tabuleiro Banco Imobiliário
Naruto Shippuden = Luta Round
Need for Speed Rivals = Corrida Bandido / Polícia
Nobunaga Ambition = Estratégia Conquista
PES = Esportes Futebol
Plants vs Zombie = Ação Estratégia Defenda sua Base
Project Diva = Música
Pumpex BMX = Bike Fase
Pure Chess = Xadrez
Resident Evil = Ação
Risk = Estratégia War
Rogue Legacy = Fase 2D Infinito
Scenet It = Perguntas
Sengoku Basara: Samurai Heroes = 1 contra vários
Sid Meier = Estratégia Age of Empire
Skyrim = Ação 
Sonic Generations = Fase 2D
Street Fighter = Luta Round
Terraria = Ação RPG 
Tetris = Tetris
The King of Fighter = Luta Round
The Sims 3 Pets = Simulação
Under Defeat HD Deluxe = Nave Tiro
Uno = Cartas
Virtua Tennis 4 = Tênis
Who Want to be a Millionaire Special = Perguntas
Winning Post  = Corrida de Cavalo
XBlaze Lost Memories = Ficção Cientícia
Yu-Gi-Oh 5Ds ou Millenium = Cartas